a	영어 알파벳의 첫번째 글자 a.최초의
a few	조금은 있는
a fond	충분히
a fortiori	한층 유력한 이유로
a good many	상당히 많은
a great many	굉장히 많은
a la mode	유행의
a little	조금은
a lot of	많은(=lots of)
a.d.	그리스도기원
a.m.	오전
ab	n.학사(Artium Baccalaureus
aba	n.낙타(염소)의 털로 짠 옷감
abaca	n.마닐라삼(필리핀 주산)
abaci	n.abcus의 복수형
aback	ad.뒤로
abacus	n.계산기
abaft	ad.(배의)고물에
abalone	abalone
abandon	vt.버리다
abandoned	a.버림받은
abandoner	n.유기자
abandonment	n.포기
abas	n.(그리스 신화)아바스
abase	vt.(품격 등을)떨어뜨리다
abasement	n.(품위의)실추
abash	vt.무안하게 하다
abashment	n.수치
abate	vt.줄이다
abatement	n.인하
abatis	n.녹채
abattis	n.녹채
